%%%%%%%%%%%%%%%%%%%%%%%%%%
%                %       %
%%%%%%.....%%%        %%%%
%%%%%%%  %%%% %%%   %%%%%%
%   %%%%               . %
%%%   %%%   %%    . %%%%%%
%  %  ....%%%%           %
%              %%%%%%    %
% P %%%%%         %      %
%    %  %%%%  .   %      %
%                 %      %
%  %   %%%%%%%           %
%%%%%%%             %%%%%%
%      .                 %
%             .....      %
%%%%%    %%%%    %% %%%%%%
%  %        %%%%%        %
%     %%%%            .  %
%                        %
%%%   . %%%%%%%%%%...%%%%%
%%%%%%%%%%%%%%%%%%%%%%%%%%